wwwwwwwwwwwwwwwwwwwwwwwww
w...m...m...m...m...m...w
w.......................w
w.......................w
w.......................w
w........m..............w
w.......................w
w...........A...........w
w.......................w
w..............m........w
w.......................w
w...c....c......c...c...w
wwwwwwwwwwwwwwwwwwwwwwwww
