wwwwwwwwwwwwwwwwwwwwwwww
w....f..f......f..f....w
w......................w
w...........f..........w
w......................w
w......................w
w......................w
w...........A..........w
w......................w
w......................w
w......................w
w...c.c....c....c.c....w
wwwwwwwwwwwwwwwwwwwwwwww
