wwwwwwwwwwwwwwwwwwwwwwww
wwwwwwwwwwwwdwwwwwwwwwww
wwwwwwwwwwww.wwwwwwwwwww
wwwwwwwwwwww.wwwwwwwwwww
wd...wwwwwww.wwwwwww..dw
wwww.wwwwwww.wwwwwww.www
w......................w
w......................w
w......................w
w......................w
w......................w
w......................w
w......................w
w......................w
w......................w
w......................w
w...........A..........w
w......................w
w...m...m...m...m...m..w
wwwwwwwwwwwwwwwwwwwwwwww

