wwwwwwwwwwwwwwwwwwwwwwww
w...n...n...n...n...n..w
w......................w
w......................w
w......................w
w...........A..........w
w......................w
w......................w
w......................w
w......................w
w......................w
w......................w
w......................w
w......................w
w......................w
www..wwwwwww.wwwwwww..ww
wv...wwwwwww.wwwwwww..vw
wwwwwwwwwwww.wwwwwwwwwww
wwwwwwwwwwwwvwwwwwwwwwww
wwwwwwwwwwwwwwwwwwwwwwww