wwwwwwwwwwwwwwwwwwwwwwww
wwwwwwwwwwwwdwwwwwwwwwww
wwwwwwwwwwww.wwwwwwwwwww
wwwwwwwwwwww.wwwwwwwwwww
wd...wwwwwww.wwwwwww..dw
wwww.wwwwwww.wwwwwww.www
w.........n...n........w
w......................w
w......................w
w......................w
w......................w
w......................w
w......................w
w......................w
w...........A..........w
w...m...m...m...m...m..w
wwwwwwwww..www..wwwwwwww
wwwwwwwww..www..wwwwwwww
wwwwwwwww..www..wwwwwwww
wv.........www........vw
wwwwwwwwwwwwwwwwwwwwwwww
