wwwwwwwwwwwwwwwwwwwwwww
w.....................w
w.....................w
w2....................w
w2....................w
w2............A.......w
w2....................w
w2....................w
w2....................w
w..................3..w
wwwwwwwwwwwwwwwwwwwwwww
