wwwwwwwwwwwwwwwwwwwwwww
w.....................w
w.....................w
w2...................1w
w2...................1w
w2...................1w
w2...................1w
w........A...........1w
w2....................w
w.............3.......w
wwwwwwwwwwwwwwwwwwwwwww