wwwwwwwwwwwwwwwwwwwwwww
w.....................w
w.....................w
w..........A..........w
w.....................w
w....................1w
w2....................w
w....................1w
w2....................w
w..........3..........w
wwwwwwwwwwwwwwwwwwwwwww