wwwwwwwwwwwwwwwwwww
wA..w...v.h..w...xw
wo.iw........w....w
wwwww......o.w.w..w
wo.....w.......w.ow
w.h....wwwwww....ww
w............h....w
wwwww.....www.....w
w.........i.......w
wg.3....v....x..www
wwwwwwwwwwwwwwwwwww