wwwwwwwwwwwwwwwwwww
wr......w........Aw
w..i.v..wi..h.....w
w.......w.......o.w
w....wwwwwwwwwwwwww
w..h..........2...w
wwwwww..w...w.....w
w.3..w..w...w.ww..w
wh...wv.ov..v...v.w
wg...w..w.....r...w
wwwwwwwwwwwwwwwwwww
