wwwwwwwwwwwwwwwwwww
w.2i..............w
w.i..x............w
w....v......v.....w
w......v.A........w
w.h...............w
w........h........w
w..r..wwww........w
w.....wg3w.......ow
wwwwwwwwwwwwwwwwwww