wwwwwwwwwwwwwwwwwwwwww
wA....w....p.......g.w
ww..1.w......p.......w
w.1...p......2..w...ww
wwwwwww1........w...ww
ww............q......w
w....p....q........1.w
w.....2..............w
w.........2..........w
wwwwwwwwwwwwwwwwwwwwww
