wwwwwwwwwwwwwwwwwwwwww
w....1...p....w..w.w.w
w..1.w.p......w1..1.ww
w.g..w.....p......11.w
wwwwwwwwwwwwwwwwwww.ww
w...w..p..w......w...w
wwww.q....w.1.w..w...w
w.A..1ww.q....w..ww.ww
w..w..w.w.w...w.....ww
wwwwwwwwwwwwwwwwwwwwww
