wwwwwwwwwwwwwwwwwwwwww
w.........w..........w
w.....p...x..........w
w............y..w....w
w....w.p.............w
w..........y...z.....w
w...x....z...........w
w..............w.....w
w..........A.........w
wwwwwwwwwwwwwwwwwwwwww
