wwwwwwwwwwwwwwwwwwwwww
wA........w..........w
w....a.w..x...p......w
w................w...w
w....w.....w.........w
w...w..........e.....w
w...x....e.......w...w
w..........a.....p...w
w....................w
wwwwwwwwwwwwwwwwwwwwww
