wwwwwwwwwwwwwwwwwwwwww
w.........w..........w
w.w..a....x....p.....w
w....................w
w..p..w....w.........w
w..............y.....w
w...x....y...........w
w.....w....a....w....w
w..........A.........w
wwwwwwwwwwwwwwwwwwwwww
