wwwwwwwwwwwwwwwwwwwwww
wfA.......w.........fw
w....a....x..........w
w..............f.....w
w.w.........w........w
w......f.............w
w..............w..x..w
w...w......a.........w
wf..................fw
wwwwwwwwwwwwwwwwwwwwww
