wwwwwwwwwwwwwwwwwwwwwwww
w......w.....k.........w
w..c........c....w..A..w
w......................w
w.gw...........w.......w
w.c....w.........c.....w
w.........cw...........w
w....w.................w
w.g..c...g...w...c...k.w
w.c.................c..w
wwwwwwwwwwwwwwwwwwwwwwww
