wwwwwwwwwwwwwwwwwwwwwwww
w......................w
w......................w
w....A...cg....c.......w
w...............c.c....w
w......................w
w.................c....w
w......................w
w......................w
w......................w
wwwwwwwwwwwwwwwwwwwwwwww
