wwwwwwwwwwwwwwww
w.....A...fo1.ow
w.........fo..ow
w.........fffffw
w..............w
w....b.........w
w.b............w
w..............w
wwwwwwwwwwooowww
w..d...........w
w..............w
wb.....b.......w
w..............w
w.........g....w
wwwwwwwwwwwwwwww
