wwwwwwwwwwwwwwww
w.....A........w
w..............w
w..........b...w
w...b..........w
w..............w
w...b..........w
w..............w
wwwwwwwwww...www
w..............w
w..............w
w..b...........w
w.........d....w
w.........g....w
wwwwwwwwwwwwwwww
