wwwwwwwwwwwwwwwwwwwwwwwwwwwwwwww
w2.............................w
w000...........................w
w000...........................w
w..............................w
w..............................w
w..............................w
w000000000000000000000000000000w
w..............................w
w000000000000000000000000000000w
w..............................w
w.............................Aw
wwwwwwwwwwwwwwwwwwwwwwwwwwwwwwww
