wwwwwwwwwwwwwwwwwwwwwwwwwwwwwwww
w1.............................w
w000...........................w
w000...........................w
w..............................w
w..............................w
w..............................w
w..............................w
w....000......000000.....000...w
w...00000....00000000...00000..w
w...0...0....00....00...00000..w
w................A.............w
wwwwwwwwwwwwwwwwwwwwwwwwwwwwwwww